111111111111111111111
1P00000111100000000C1
101110001001111110101
100010001001000000001
101011101111011111101
100000100000010000001
101110111011110111101
100010000000000010001
101011101111110101101
1000001010000001000E1
111110101011111101111
1C00000000000000000C1
111111111111111111111
