111111111111
100C0000000P
1111111E1111