11111111111111
1P0000000000P1
101010000C0111
10101E00000001
11111111111111
