111111111111111
10011P111110E11
111111111111111