11111111111111
1P00000000C001
11111111111111
