1111111111
1E0C000001
1111111111
