11111111111
101C1000P01
101110E0001
11111111111
