11111111111111111111
1P000001000000000C01
10111101011111111101
10100001010000000001
10101110010111111101
10101000010000000101
10101011111111110101
10101000000000010101
10101111111111010101
10100000000001010101
10111111111101010101
1C000000000101000001
11111111110101111101
10000000010100000101
10111111010111110101
10100000010000010101
10101111111110010101
10101000000000010101
101011111111111101C1
1E000000000000000001
11111111111111111111
