1111111111111
1001000000001
1000011111001
1P0011E000001
1000011C11001
1C00000011001
1111111111111